{
  "level" : {
    "0, 0" : "f",
    "0, 1" : "t",
    "0, 2" : "f",
    "0, 3" : "w",
    "0, 4" : "e",
    "0, 5" : "w",
    "0, 6" : "f",
    "0, 7" : "t",
    "0, 8" : "w",
    "1, 0" : "w",
    "1, 1" : "w",
    "1, 2" : "d, g",
    "1, 3" : "w",
    "1, 4" : "l",
    "1, 5" : "w",
    "1, 6" : "d, g",
    "1, 7" : "w",
    "1, 8" : "w",
    "2, 0" : "k, g",
    "2, 1" : "d, b",
    "2, 2" : "f",
    "2, 3" : "f",
    "2, 4" : "f",
    "2, 5" : "f",
    "2, 6" : "f",
    "2, 7" : "d, r",
    "2, 8" : "k, g",
    "3, 0" : "f",
    "3, 1" : "w",
    "3, 2" : "k, b",
    "3, 3" : "f",
    "3, 4" : "i",
    "3, 5" : "f",
    "3, 6" : "k, r",
    "3, 7" : "w",
    "3, 8" : "f",
    "4, 0" : "w",
    "4, 1" : "w",
    "4, 2" : "t",
    "4, 3" : "f",
    "4, 4" : "f",
    "4, 5" : "f",
    "4, 6" : "t",
    "4, 7" : "w",
    "4, 8" : "w",
    "5, 0" : "f",
    "5, 1" : "w",
    "5, 2" : "k, b",
    "5, 3" : "f",
    "5, 4" : "f",
    "5, 5" : "f",
    "5, 6" : "k, r",
    "5, 7" : "w",
    "5, 8" : "f",
    "6, 0" : "w",
    "6, 1" : "d, r",
    "6, 2" : "f",
    "6, 3" : "f",
    "6, 4" : "t",
    "6, 5" : "f",
    "6, 6" : "f",
    "6, 7" : "d, b",
    "6, 8" : "f",
    "7, 0" : "w",
    "7, 1" : "w",
    "7, 2" : "w",
    "7, 3" : "w",
    "7, 4" : "w",
    "7, 5" : "w",
    "7, 6" : "w",
    "7, 7" : "w",
    "7, 8" : "w",
    "8, 0" : "f",
    "8, 1" : "w",
    "8, 2" : "f",
    "8, 3" : "f",
    "8, 4" : "w",
    "8, 5" : "f",
    "8, 6" : "f",
    "8, 7" : "w",
    "8, 8" : "f"
  },
  "char" : "4, 4",
  "gridSize" : 9,
  "treasures": 5
}