{
  "level" : {
    "0, 0" : "w",
    "0, 1" : "w",
    "0, 2" : "d",
    "1, 0" : "f",
    "1, 1" : "f",
    "1, 2" : "f",
    "2, 0" : "k",
    "2, 1" : "f",
    "2, 2" : "f"
  },
  "char" : "1, 1",
  "gridSize" : 3
}